11111111111111111111111111111
1010E0000P0000000010010111101
10000000000000000000000C10011
11111111111111111111111111111