111111111
1P0000001
101011101
100000001
101111101
1000C00E1
111111111
