1111111111111
1P000000000E1
1111011111101
1000010000101
1011010110101
1C10100001001
1111111111111
