1111111111111111111111
1010001111101110101111
1010101111111111111011
1000000P00000D00001111
10111010110111C0111011
1011111011001010001011
1000111011111010111011
1010101011111010101011
1110111010001110111011
1000C00C101010000000E1
1111111111000000C00011
1000000000000000000001
1111111111000000C00011
1111111111111111111111