1111111111111111111111
1PCCCCCCCCCCCCCCCCCCC1
1011111111111111111101
1CCCCCCCCCCCCCCCCCCCC1
1011111111111111111101
1CCCCCCCCCCCCCCCCCCCC1
1011111111111111111101
1ECCCCCCCCCCCCCCCCCCC1
1111111111111111111111
