1111111111111111111111111111111
1P00000000000000000000C00000001
1111101111110111111101111101111
1C0001000000C0000001000000C0001
1011110111110111110101111101111
100000C00000C000000C00000C00001
1111101111110111111101111101111
1C0001000000C0000001000000C0001
1011110111110111110101111101111
1D0000C00000C000000C00000C000D1
1111101111110111111101111101111
1C0001000000C0000001000000C0001
1011110111110111110101111101111
100000C00000C000000C00000C00001
1111101111110111111101111101111
1C0001000000C0000001000000C0001
1011110111110111110101111101111
1D0000C00000C000000C00000C000D1
1111101111110111111101111101111
1C0001000000C0000001000000C0001
10000000000000000000000000000E1
1111111111111111111111111111111



