1111111111111111111
1P0000D000000000E01
1011101110111011101
1000100000100000101
101010D101010101011
1C000000000000000C1
1111111111111111111
