11111111111111111111111111111111111111111
1PDDCCCCDDCCCCDDCCCCDDCCCCDDCCCCDDCCCCDD1
1CCCCDDCCCCDDCCCCDDCCCCDDCCCCDDCCCCDDCCC1
111111111111111111111111111111111111111C1
1CCCCDDCCCCDDCCCCDDCCCCDDCCCCDDCCCCDDCCC1
1CDDCCCCDDCCCCDDCCCCDDCCCCDDCCCCDDCCCCDD1
1C111111111111111111111111111111111111111
1CDDCCCCDDCCCCDDCCCCDDCCCCDDCCCCDDCCCCDD1
1CCCCDDCCCCDDCCCCDDCCCCDDCCCCDDCCCCDDCCC1
111111111111111111111111111111111111111C1
1CCCCDDCCCCDDCCCCDDCCCCDDCCCCDDCCCCDDCCC1
1CDDCCCCDDCCCCDDCCCCDDCCCCDDCCCCDDCCCCDE1
11111111111111111111111111111111111111111
