111111111111111111111111111111111111
1P0000000000000C00000C00CC00C00C0001
111111111111111111111111111111111101
10000000000000CCCCCCCC00000000000001
111110111111111111111111111111111111
100C00000000000000CCCCCCCCC000000001
111110111111111111111111111111111111
1000CCCCC0000000000000C0CCC0CCCCC001
111111111111111111111111111111111101
1000000000000CCCCCCCCCCCCC0000000001
101111111111111111111111111111111111
1000CCCCCCCCCCCCCCCCCCCC0000000000E1
111111111111111111111111111111111111