111111111111
1P00000000E1
1D1100011101
10000D000001
101111111001
1C00000000D1
111111111111