111111
1P0D01
101011
1C00E1
111111
