111111111111111
1P0001000100001
101011101011101
100010000010001
101110111011101
1000000000000C1
1C011111110E001
111111111111111
