1111111111111111
1P00000000000101
1011101100111011
1000100000100011
1010111001101011
1C0001000000E001
1111111111111111





