11111111111111111111
1P001000000000100001
11101011111010101111
10001010001010001001
10111011101011111111
10001000001010000011
11101111111010111011
1000000000000C001001
1C111011101111101111
10000010000000010111
11111110111110001D11
1010000000001C101011
10101111111010101011
10101000001000100C11
10101011111110111111
10001C00000010000001
10111111111E00101111
10000000001010101001
11111111101010101011
11111111111111111111
